NO ./textures/2_houses.png
SO ./textures/4_animals.png
WE ./textures/3_forest.png
EA ./textures/1_flowers.png
F 126,73,21
C 0,115,133

1111111111111111111111111
  1100000000011000000001
  101100000111000000001111
11111000000000011110000001111
100100000000000000000000111111111
111111111011000001110000000000001
100000000011000001110111111111111
11110111111111011100000010001
 1110111111111011101010000001
11000000110101011100000010001
10000000000000001100000010001
10000000000000001101010010001
11000001110101011101011010N0111
 1110111 1110101 101111010001
11111111 1111111 111111111111