NO ./textures/2_houses.png
SO ./textures/4_animals.png
WE ./textures/3_forest.png
EA ./textures/1_flowers.png

F 126,73,21
C 0,115,133


11111111           11111111
 11000011           11000011
  11000011           11000011
   11000011           11000011
    110000111111111111111000011
     110000000000000000000000N11
    110000111111111111111000011
   11000011           11000011
  11000011           11000011
 11000011           11000011
11111111           11111111