NO ./textures/dogs.png
SO ./textures/dogs.png


C 62, 180, 137
WE ./textures/dogs.png
EA ./textures/dogs.png





F 27, 27, 27






11111111           11111111
 11000011           11000011
  11000011           11000011
   11000011           11000011
    110000111111111111111000011
     110000000000000000000000N11
    110000111111111111111000011
   11000011           11000011
  11000011           11000011
 11000011           11000011
11111111           11111111