NO ./textures/dogs.png
SO ./textures/dogs.png


C 225,30,0
WE ./textures/dogs.png
EA ./textures/dogs.png





F 220,100,0






11111111           11111111
 11000011           11000011
  11000011           11000011
   11000011           11000011
    110000111111111111111000011
     110000000000000000000000E11
    110000111111111111111000011
   11000011           11000011
  11000011           11000011
 11000011           11000011
11111111           11111111