NO ./textures/2_houses.png
SO ./textures/4_animals.png
WE ./textures/3_forest.png
EA ./textures/1_flowers.png

F 126,73,21
C 0,115,133

1111111111111111111111111
1000000000110000000000001
1011000001110000N00000001
100100000000000000000000111111111
111111111011000001110000000000001
100000000011000001110111111111111
11110111111111011100000010001
11110111111111011101010000001
1100000011010101110000001000111
10000000000000001100001010001 1
1000000000000000110101001000111
110000011101010111110111100111
11110111 1110101 101111010001
11111111 1111111 111111111111
1111
