F 126,73,21
C 0,115,133

NO ./textures/2_houses.png
SO ./textures/4_animals.png


WE ./textures/3_forest.png
EA ./textures/1_flowers.png

1111111
1111111
1001111
1001111
1N011
1111
1