NO ./textures/2_houses.png
SO ./textures/4_animals.png
WE ./textures/3_forest.png
EA ./textures/1_flowers.png

F 126,73,21
C 0,115,133


11111111
100110N1
10011001
10000001
11100111
10000001
10011001
11111111